................................................................................
................................................................................
.......................................d........................................
....................d..............k.........m..................................
.g...m.a...2..h.d...1...d.d..h..d..1..h.j...cccm....2...i..i..m..j...d.d..m..1..
111111111111f111111111111111111111111111111111111111111p111111111111111111111111

