...................1111................dd.........................
...............cd......................111......c.....c...........
..................................................................
.........................i........................................
.ak..g........mlh....1...d1...c.1.j....c..d..k..h.....d.....k..h..
11111111111111111111111111111111111111111111111111111111q111111111






